1111111111111
1P001000100C1
100E000000001
1000000000001
1000000000001
1111111111111