1111111111111
1E010000C00C1
10P0011111001
1P0011E000C01
1111111111111