1111111111111
1P001000100C1
100E00C000001
100C00000C001
100000C000001
1111111111111