1111111111111
11010001000C1
1P0E000110001
1000000000001
1000111111001
1111111111111